0,0,0,0,0,0,0,0,0,0,0,0,0,0,0,0,0,0,0,0,0,0,0,0,0,0,0,0,0,0,0,0,0,0,0,0,0,0,0,0,0,0,0,0,0,0,0,0,0,0,0,0,0,0,0,0,0,0,0,0
0,0, , , , , , , , , , ,0,0, , , , , , , , , , , , , , , , , , , , , , , , , , , , ,0,0, , , , , , , , , , , , , , , ,0
0,0, , , , , , , , , , ,0,0, , , , , , , , , , , , , , , , , , , , , , , , , , , , ,0,0, , , , , , , , , , , , , , , ,0
0,0, , , , , , , , , , ,0,0, , , , , , , , , , , , , , , , , , , , , , , , , , , , ,0,0, , , , , , , , , , , , , , , ,0
0,0, , , , , , , , , , ,0,0, , , , , , , , , , , , , , , , , , , , , , , , , , , , ,0,0, , , , , , , , , , , , , , , ,0
0,0, , , , , , , , , , ,0,0, , , , , , , , , , , , , , , , , , , , , , , , , , , , ,0,0, , , , , , , , , , , , , , , ,0
0,0, , , , , , , , , , ,0,0, , , , , , , , , , , , , , , , , , , , , , , , , , , , ,0,0, , , , , , , , , , , , , , , ,0
0,0, , , , , , , , , , ,0,0, , , , , , , , , , , , ,10, , , , , , ,10, , , , , , , , ,0,0, , , , , , , , , , , , , , , ,0
0,0, , , , , , , , , , ,0,0, , , , , , , , ,6,6,6,6,6,6,6,6,6,6,6,6,6,6,6,6,6, , , ,0,0, , , , , , , , , , , , , , , ,0
0,0, , , , , , , , , , ,0,0, , , , , ,6,6,6,0,0,0,0,0,0,0,0,0,0,0,0,0,0,0,0,0,6, , ,0,0, , , , , , , , , , , , , , , ,0
0,0, , , , , , , , , , ,0,0, , ,3,3, ,0,0,0,0,0,0,0,0,0,0,0,0,0,0,0,0,0,0,0,0,0,6, ,0,0, , , , , , , , , , , , , , , ,0
0,0, , , , , , , , , , ,0,0, , , , , , , , ,0,0, , , , , , , , , , , , , , , , , , ,0,0, , , , , , , , , , , , , , , ,0
0,0, , , , , , , , , , ,0,0,3, , , , , , , ,0,0, , , , ,10, , , , ,10, , , , , , , , ,0,0, , , , , , , , , , , , , , , ,0
0,0, , , , , , , , , , ,0,0,0,3, , , , , , ,0,0, , ,6,6,6,6,6,6,6,6,6,6,6,6,6,6,6,6,0,0, , , , , , , , , , , , , , , ,0
0,0, , , , , , , , , , ,0,0,0,0,3, , , , , ,0,0, , ,0,0,0,0,0,0,0,0,0,0,0,0,0,0,0,0,0,0, , , , , , , , , , , , , , , ,0
0,0, , , , , , , , , , ,0,0,0,0,0,3, , , , ,0,0, , ,0,0,0,0,0,0,0,0,0,0,0,0,0,0,0,0,0,0, , , , , , , , , , , , , , , ,0
0,0, , , , , , , , , , , , , , , , , , ,6,6,0,0,6, , , , , , , , , , , , , , , , , ,0,0, , , , , , , , , , , , , , , ,0
0,0, , , , , , , , , , , , , , , , , , , , , , , , , , , , , , , , , , , , , , , , ,0,0, , , , , , , , , , , , , , , ,0
0,0, , , , , , , , , , , , , , , ,6,6,7,7,7,7,7,6,6,6,6,6,6,6,6,6,6,6,6,6,6,6,6, , ,0,0, , , , , , , , , , , , , , , ,0
0,0, , , , , , , , , , , , , , ,6,0,0,8,8,8,8,8,0,0,0,0,0,0,0,0,0,0,0,0,0,0,0,0, , ,0,0, , , , , , , , , , , , , , , ,0
0,0, , , , , , , , , , , , , ,6,0,0,0,0,0,0,0,0,0,0,0,0,0,0,0,0,0,0,0,0,0,0,0,0,6, ,0,0, , , , , , , , , , , , , , , ,0
0,0, , , , , , , , , , , , ,6,0,0,0,0,0,0,0,0,0,0,0,0,0,0,0,0,0,0,0,0,0,0,0,0,0,0, ,0,0, , , , , , , , , , , , , , , ,0
0,0, , , , , , , , , , , ,6,0, , , , , , , , , , , , , , , , , , , , , , , , , , , ,0,0, , , , , , , , , , , , , , , ,0
0,0, , , , , , , , , , ,6,0, , , , , , , , , , , , , , , , , , , , , , , , , , , , ,0,0, , , , , , , , , , , , , , , ,0
0,0, , , , , , , , , ,6,0, , , , , ,6,6,6,6,6,6,6,6,6,6,6,6,6,6,6,6,6,6,6,6,6,6,6,6,0,0, , , , , , , , , , , , , , , ,0
0,0, , ,9, , , , , ,6,0, , , , , , , , , , , , , , , , , , , , , , , , , , , , , , , , , , , , , , , , , , , , , , , ,0
0,0, , , , , , , ,6,0, , , , , , ,10, , , , , , , , , , , ,10, , , , , , , , , , , , ,10, , , , ,3, ,3, ,3, ,3, , , ,11, ,0
0,0,6,6,6,6,6,6, , , , ,6,6,6,6,6,6,6,6,6,6,6,6,6,6,6,6,6,6,6,6,6,6,6,6,6,6,6,6,6,6,6,6,6,6, , , , , , , , ,6,6,6,6,6,0
0,0,0,0,0,0,0,0,1,1,1,1,0,0,0,0,0,0,0,0,0,0,0,0,0,0,0,0,0,0,0,0,0,0,0,0,0,0,0,0,0,0,0,0,0,0,1,1,1,1,1,1,1,1,0,0,0,0,0,0
0,0,0,0,0,0,0,0,2,2,2,2,0,0,0,0,0,0,0,0,0,0,0,0,0,0,0,0,0,0,0,0,0,0,0,0,0,0,0,0,0,0,0,0,0,0,2,2,2,2,2,2,2,2,0,0,0,0,0,0
 , , , , , , , , , , , , , , , , , , , , , , , , , , , , , , , , , , , , , , , , , , , , , , , , , , , , , , , , , , , 
 , , , , , , , , , , , , , , , , , , , , , , , , , , , , , , , , , , , , , , , , , , , , , , , , , , , , , , , , , , , 
 , , , , , , , , , , , , , , , , , , , , , , , , , , , , , , , , , , , , , , , , , , , , , , , , , , , , , , , , , , , 
 , , , , , , , , , , , , , , , , , , , , , , , , , , , , , , , , , , , , , , , , , , , , , , , , , , , , , , , , , , , 
 , , , , , , , , , , , , , , , , , , , , , , , , , , , , , , , , , , , , , , , , , , , , , , , , , , , , , , , , , , , 
 , , , , , , , , , , , , , , , , , , , , , , , , , , , , , , , , , , , , , , , , , , , , , , , , , , , , , , , , , , , 
 , , , , , , , , , , , , , , , , , , , , , , , , , , , , , , , , , , , , , , , , , , , , , , , , , , , , , , , , , , , 
 , , , , , , , , , , , , , , , , , , , , , , , , , , , , , , , , , , , , , , , , , , , , , , , , , , , , , , , , , , , 
 , , , , , , , , , , , , , , , , , , , , , , , , , , , , , , , , , , , , , , , , , , , , , , , , , , , , , , , , , , , 
 , , , , , , , , , , , , , , , , , , , , , , , , , , , , , , , , , , , , , , , , , , , , , , , , , , , , , , , , ,0,0,0
